80-80
00000000000000000000000000000000000000000000000000000000000000000000000000000000
01111111111000111100011110111111111100011110001111111111000111100111111000111100
01000000010100100100010000100000001010010010001000000001000100100000001000100100
01001111111111100111110010100111111111110011111001111111111100111111111111100100
01001000010100000100010011100100001010000010001001000000100000100000000100000100
01001000000100000000010010100100000010000000001001000000100000000000000100000000
01001000000111111100010010100100000011111110001001000000111111100000000111111100
01111000000100000000011110111100000010000000001111000000100000000000000100000000
00001000000100000001110010000100000010000000111001000000100000000000000100000000
00000000000100000001000000000000000010000000100000000000100000000000000100000000
00000000011111000001000000000000001111100000100000000011111000000000011111000000
00000000010001000001000000000000001000100000100000000010001000000000010001000000
00000011110001000001000000000001111000100000100000011110001000000011110001000000
00000000000001000001000000000000000000100000100000000000001000000000000001000000
00000000000001000001000000000000000000100000100000000000001000000000000001000000
00000000001111111111000000000000000111111111100000000001111111111000001111111110
00000000001000000011000000000000000100000001100000000001000000010000001000000010
00000001111000000011111110000000111100000001111111111111000000010111111000000010
00000001000000000011000000000000100000000001100000000100000000010010010000000010
00000001000000000001000000000000100000000000100000000100000000000011111000000000
00000000000000000001000000000000000000000000100000000100000000000000010000000000
01111111111000111101011110111111111100011110101111111111000111100111111000111100
01000000010100100101010000100000001010010010101000000001000100100000001000100100
01001111111111100111110010100111111111110011111001111111111100111111111111100100
01001000010100000100010010100100001010000010001001000000100000100000000100000100
01001000000100000000010010100100000010000000001001000000100000000000000100000000
01001000000111111100010010100100000011111110001001000000111111100000000111111100
01111000000100000000011110111100000010000000001111000000100000000000000100000000
00001000000100000001110010000100000010000000111001000000100000000000000100000000
00000000000100000001000000000000000010000000100000000000100000000000000100000000
00000000011111000001000000000000001111100000100000000011111000000000011111000000
00000000010001000001000000000000001000100000100000000010001000000000010001000000
00000011110001000001000000000001111000100000100000011110001000000011110001000000
00000000000001000001000000000000000000100000100000000000001000000000000001000000
00000000000001000001000000000000000000100000100000000000001000000000000001000000
00000000001111111111000000000000000111111111100000000001111111111100001111111111
00000000001000000011000000000000000100000001100000000001000000010100001000000010
00000001111000000011111110000000111100000001111111111111000000010111111000000010
00000001000000000011000000000000100000000001100000000000000000010000000000000010
00000001000000000001000000000000100000000000100000000000000000000000000000000000
00000001000000000001000000000000100000000000100000000000000000000000000000000000
01111111111000111101011110111111111100011110101111111111000111111111111000111100
01000000001000100101010000100000000100010010101000000001000100100000001000100100
01001111111111100111110010100111111111110011111001111111111100100111111111100100
01001000000100000101010010100100000010000010101001000000100000100000000100000100
01001000000100000001010010100100000010000000101001000000100000000000000100000000
01001000000111111101010010100100000011111110101001000000111111100000000111111100
01111000000100000001011110111100000010000000101111000000100000000000000100000000
00001000000100000001000010000100000010000000100001000000100000000000000100000000
00000000000100000001000000000000000010000000100000000000100000000000000100000000
00000000011111000001000000000000001111100000100000000011111000000000011111000000
00000000010001000001000000000000001000100000100000000010001000000000010001000000
00000011110001000001000000000001111000100000100000011110001000000011110001000000
00000000000001000001000000000000000000100000100000000000001000000000000001000000
00000000000001000001000000000000000000100000100000000000001000000000000001000000
00000000001111111111000000000000000111111111100000000001111111110000001111111110
00000000001000000010000000000000000100000001000000000001000000010000001000000010
00000001111000000011111110000000111100000001111111111111000000010111111000000010
00000000000000000010000000000000000000000001100000000000000000010000000000000010
00000000000000000011000000000000000000000000100000000000000000010000000000000010
00000001000000000001000000000000100000000000100000000000000000000000000000000000
01111111111000111101011110111111111100011110101111111111000111100111111000111100
01000000001000100101010000100000000100010010101000000001000100100000001000100100
01001111111111100111110010100111111111110011111001111111111100100111111111100100
01001000000100000101010010100100000010000010101001000000100000100000000100000100
01001000000100000001010010100100000010000000101001000000100000000000000100000000
01001000000111111101010010100100000011111110101001000000111111100000000111111100
01111000000100000001011110111100000010000000101111000000100000000000000100000000
00001000000100000001000010000100000010000000100001000000100000000000000100000000
00000000000100000001000000000000000010000000100000000000100000000000000100000000
00000000011111000001000000000000001111100000100000000011111000000000011111000000
00000000010001000001000000000000001000100000100000000010001000000000010001000000
00000011110001000001000000000001111000100000100000011110001000000011110001000000
00000000000001000001000000000000000000100000100000000000001000000000000001000000
00000000000001000001000000000000000000100000100000000000001000000000000001000000
00000000001111111111000000000000000111111111100000000001111111110000001111111110
00000000001000000010000000000000000100000001000000000001000000010000001000000010
00000001111000000011111110000000111100000001111111111111000000011111111000000010
00000000000000000010000000000000000000000001000000000000000000010000000000000010
00000000000000000000000000000000000000000000000000000000000000000000000000000000